NO ./maps/greystone.xpm
F 105,105,105
SO ./maps/colorstone.xpm

WE ./maps/wood.xpm
EA ./maps/mossy.xpm
C 240,230,140

        1111111111111111111111111
        1000000000110000000001001
        1011000001110010011001001
        1001000001000000011001001
111111111011000001110010000001001
100000000011000001110111111111111
11110111111111011100000010001
11111111101111011101010010001
11000000110101011100000010001
10000000000000001100000010001
10000000000000001111110010001
1100N0011101010000010111100111
11111111 11101011100000000001
11111111 1111111 111111111111