NO ./maps/pupone2.xpm
F 105,105,105
SO ./maps/pupone2.xpm
WE ./maps/pupone2.xpm

C 240,230,140
EA ./maps/pupone2.xpm

   D    1111111111111111111111111
  D0D   100000000011000000000D001
   D    1011000001110010011001001
        100100000D00000001100D001
111111111011000001110010000001001
100000000011000001110111111111111
11110111111111011100000010001
1111D111101111011101010010001
1100000011010101110000001000111111111111111111 
10000000000000011100000010000000000000000000001 
100000100000000D00000000000000000000000000000001 
10000010000000111110000000000000011111111000111 
11001111111001111000000000000000010000001000111 
100011111111111000000001000000000D00000010000001 
10000000000000001111110010000000010000001000011 
1100W001110101000001011110000000011111111000001 
11111111 11101011100000000000000000000000000001 
11111111 1111111 11111111111111111111111111111 
