NO ./maps/bluestone.xpm
SO ./maps/bluestone.xpm
WE ./maps/bluestone.xpm
EA ./maps/bluestone.xpm

F 105,105,105
C 64,64,64

        1111111111111111111111111
        100000000011000000000D001
        1011000001110010011001001
        100100000D00000001100D001
111111111011000001110010000001001
100000000011000001110111111111111
11110111111111011100000010001
1111D111101111011101010010001
11000000110101011100000010001
100000000000000011000000D0001
10000000000000001111110010001
1100N0011101010000010111100111
11111111 11101011100000000001
11111111 1111111 111111111111